%%%%%%%%%%%%%%%%%%%%%%%%%
%o. P  ....      ....  o%
%..  ...  ...  ...  ... %
%..  ...  ...  ...  ... %
%..    ....      .... G %
%..  ...  ...  ...  ... %
%..  ...  ...  ...  ... %
%o. G  ....      ....  o%
%%%%%%%%%%%%%%%%%%%%%%%%%
