%%%%%%%%%%%%%%%%%%%%%%%%%%%%%%%%
%.  %. %.%.%     . %     %.%. 1%
% % %%       %%  %   %%%   %.% %
% % %. % %%%    %%%% .%..% % % %
% % %% % ..% %   %   %%%%% % % %
% %    %%%%% %%%   %%%.%   % % %
% %% % ..%.  %.%%%       %   % %
% %. %%.%%%%        %.%%%%  %% %
% %%  %%%%.%        %%%%.%% .% %
% %   %       %%%.%  .%.. % %% %
% % %   %.%%%   %%% %%%%%    % %
% % % %%%%%   %   % %.. % %% % %
% % % %..%. %%%%    %%% % .% % %
% %.%   %%%   %  %%       %% % %
%1 .%.%     % .     %.%.% .%  .%
%%%%%%%%%%%%%%%%%%%%%%%%%%%%%%%%
